%%%%%%%%%%%%%%%%%%%%%%
% %%.       % %P     %
%    %% %%% % %      %
%%%%          %     .%
%    % %%%%%% %%%%% %%
%%%%%%%%     .   %   %
%  .     %%% %%%   % %
%%%%%%%%%%    %%%%%% %
%.     .   %%        %
%        %       .   %
%%%%%%%%%%%%%%%%%%%%%%